bg_image_3.jpg
850
200
|------------------------------------------------------------------------------------------|
|------------------------------------------------------------------------------------------|
|-------------------------------------------------0------0---------------------------------|
|---0--------------------------------00-----------0------G----G-----G----GG----------------|
|---0--------0-------00---------------G----0------GG-----------------------------G---------|
|---G------GGGG------GG---------GG---------G--------------------0--G-----------------------|
|---------------------------G----#--------------------G---------0--------------------------|
|---P-G--------G--0--------------#G--------------G--------------G-------------------^--D---|
|----------------GG--------------#--------------------------------------------------GGGG---|
|----G-^^^^^^^^^^^^^^^^^^^^^GGGG^^^^^^^^^^^^^^^^^^^^^^^^^^^^^^^^^^^^^^^^^^^^^^^^^^^^^^^^^^^|
|------GGGGGGGGGGGGGGGGGGGGG####GGGGGGGGGGGGGGGGGGGGGGGGGGGGGGGGGGGGGGGGGGGGGGGGGGGGGGGGGGG|