bg_forest.jpg
850
200
|------------------------------------------------------------------------------------------|
|------------------------------------------------------------------------------------------|
|-------------------------------------------------0------0---------------0-------0---------|
|---0----------------00--------------00-----------0------G----G-----G----GG------0---------|
|---0--------0-------00---------------G----0------GG-----------------------------G---------|
|---G------GGGG------GG-----0---GG0--------G--------------------0--G-----------------------|
|-----0---------------------G----#0--------------0----G---------0--------------------------|
|---P-G--------G--0--------------#G--------------G--------------G-------------------^^^D---|
|----------------GG--------------#--------------------------------------------------GGGG---|
|----G-^^^^^^^^^^^^^^^^^^^^^GGGG^^^^^^^^^^^^^^^^^^^^^^^^^^^^^^^^^^^^^^^^^^^^^^^^^^^^^^^^^^^|
|------GGGGGGGGGGGGGGGGGGGGG####GGGGGGGGGGGGGGGGGGGGGGGGGGGGGGGGGGGGGGGGGGGGGGGGGGGGGGGGGGG|
