bg_night.jpg
700
35
|------------------------------------------------------------------------------------------|
|---0-----------------------------0-----------------------0---------00---------------------|
|---#-----0----#-----#-----0------#-----------------------0--------###--------------------D|
|--------------------#-----#----------------00------------#-----------------------------###|
|---------#----------#----------------------##---------------------------------00----------|
|---P----------------##--------------------------------------#---------------####----------|
|0--------------##---###-------------------------0-----------------------------------------|
|#----------0--------####-------#---------#------#---------#-----------#-------------------|
|---------####-------#####------#---------#------#-----------------------------------------|
|--------------------######^^^^^#^^^^^^^^^#^^^^^^#^---00----------^^^^^^^^^^^^^^^^^^^^^^^^^|
