bg_atack_on_titan.png
950
-140
B
B
B
B
B
B-----------------------------------------------------------------------------------------B|
B-----------------------------------------------------------------0-----------------------B|
B----------BBB----------------------000---------------------------B---------------------0DB|
B--00------B---------------B------BBBB--------------0----0-B----------------------------BBB|
B--00------B00------------0-------------------------B----0--------------------------0------|
B--BB------BBBB---0------BB------------------0-----------B--------------------------B------|
B-------------0---B-------------------------------------------------0-------------0--------|
BB-P----------0------------------------------------B----------------B------------BB--------|
B------B------B------------------------------B----------------------------BB---------------|
B^^B^^^^^^^^^^^^^^^^^^^^^^^^^^^^^^^^^^^^^^^^^^^^^^^^^^^^^^^^^^^^^^^^^^^^^^^^^^^^^^^^^^^^^^^^^^^^^^^^^^^^|
BBBBBBBBBBBBBBBBBBBBBBBBBBBBBBBBBBBBBBBBBBBBBBBBBBBBBBBBBBBBBBBBBBBBBBBBBBBBBBBBBBBBBBBBBBBBBBBBBB|