loop.jpg
700
|------------------------------------------------------------------------------------------|
|---0-----------------------------0-----------------------0---------00---------------------|
|---#-----0----#-----#------0-----#-----------------------0--------###--------------------F|
|--------------------#-----#----------------00------------#-----------------------------###|
|---------#----------#----------------------##---------------------------------00----------|
|---P----------------##--------------------------------------#---------------####----------|
|0--------------##---###-------------------------0-----------------------------------------|
|#----------0--------####-------#---------#------#---------#-----------#-------------------|
|---------####-------#####------#---------#------#-----------------------------------------|
|--------------------######-----#---------#------#----00-----------------------------------|
