loop.jpg
700
#############################|
------------------0----------|
-----00-----------##---------|
-----###---------------------|
-----------------------0-----|
----------------------##-----|
-----------------------------|
-------------P-------000-----|
#############################|
-----------------------------|
